hello - roʐu
goodbye - daga
welcome - roʐusaaŋma (hello + tea)

I - ku
You - ki
He/she - ke
We - du
y'all - di
they - de

the - e
a - a
and - kro
to - vol

future - ŋuri
past - goru
tomorrow - kido
yesterday - leʐaŋa

day - vala
night - voda
dawn - dalama
dusk - druuθe
morning - sama
noon - malaθi
afternoon - mugu
evening - dama
gray hour - regaʐa
early morning - ʐusu

safe - kiva
dangerous - drookma

tea - saaŋma
pen - bokorima
bed - dabaɸu
forest - sagoɸa

be - mu
go - bala
walk - telugu
sleep - namabi
